ΧΧΧΧ■■■■■ΧΧΧΧΧΧΧΧΧΧ
ΧΧΧΧ■　　　■ΧΧΧΧΧΧΧΧΧΧ
ΧΧΧΧ■▩　　■ΧΧΧΧΧΧΧΧΧΧ
ΧΧ■■■　　▩■■ΧΧΧΧΧΧΧΧΧ
ΧΧ■　　▩　▩　■ΧΧΧΧΧΧΧΧΧ
■■■　■　■■　■ΧΧΧ■■■■■■
■　　　■　■■　■■■■■　　□□■
■　▩　　▩　　　　　　　　　　□□■
■■■■■　■■■　■★■■　　□□■
ΧΧΧΧ■　　　　　■■■■■■■■■
ΧΧΧΧ■■■■■■■ΧΧΧΧΧΧΧΧ