■■■■■■■■■■■■■■■■■■■■
■　　　　　　　　　　　　　　　　　　■
■　　　　　　　　　　　　　　　　　　■
■　　　　　　　　　　　　　　□　　　■
■　　　　　　　　　　　　　　　　　　■
■　　　　　　　　　　　　　　　　　　■
■　　■■■■■■■■■■　　　　　　■
■　　■　　　　　　　　■　　　　　　■
■　　■　　　　　　　　■　　　　　　■
■　　■　　　　　　　　■　　　　　　■
■　　■　　　　　　　　■　　　　　　■
■　　■　　　　　　　　■　　　　　　■
■　　■■■■■■■■■■　　　　　　■
■　　　　　　　　　　　　　　　　　　■
■　　　　　　　　　　　　　　　　　　■
■　　★　　　　　▩　　　　　　　　　■
■　　　　　　　　　　　　　　　　　　■
■　　　　　　　　　　　　　　　　　　■
■　　　　　　　　　　　　　　　　　　■
■■■■■■■■■■■■■■■■■■■■
