■■■■■■■■■■■■■■■■■■■■
■　　　　　　　　　　　　　　　　　　■
■　　　　　　　　　　　　　　　　　　■
■　★■　▩　　　　　　　　　　　　　■
■　　■■　■■　　　　　　　　　　　■
■　　　　　　■　　　　　　　　　　　■
■　　　　　　　　　　　　　　　　　　■
■　　　　　　　　　　　　　　　　　　■
■　　　■　　　■　　　　　　　　　　■
■　　　　■■　■■■■■　　　　　　■
■　　　　　　　　　　□■　　　　　　■
■　　　　　　■　　　　　　　　　　　■
■　　　　　　■　■　　　　　　　　　■
■　　　　　　　　■■　　　　　　　　■
■　　　　　　　　　　　　　　　　　　■
■　　　　　　　　　　　　　　　　　　■
■　　　　　　　　　　　　　　　　　　■
■　　　　　　　　　　　　　　　　　　■
■　　　　　　　　　　　　　　　　　　■
■■■■■■■■■■■■■■■■■■■■
