■■■■■■■■■■■■■■■■■■■■
■★　　　　　　　　　　　　　　　　　■
■　■■■■■■■■■■■　　　　　　■
■　　■　　　　　　　■　　　　　　　■
■　　　■　　　　　■　　　　　　　　■
■　　　　■　　　■　　■■■■　　　■
■　■■　　■　■　　　■　　■　　　■
■　■■　　□■□　　　■■■■　　　■
■　　　　　■　■　　　　　　　　　　■
■　▩　　■　　　■　　　　　　　　　■
■　　　■　　　　　■　　　　　　　　■
■　　■　　　　　　　■　　　　　　　■
■　■■■■■■■■■■■　■■■　　■
■　　　　　　　　　　　　　■　■　　■
■　　■　　▩　　　　　　　■　■　　■
■　　■■■■　　　　　　　　　■　　■
■　　　　　■　■■■　　　　■■　　■
■　　　　　　　■　■　　　　　　　　■
■　　　　　　　■　■　　　　　　　　■
■■■■■■■■■■■■■■■■■■■■
